111111
100001
11P001
1CCEC1
111111